XXXXXXX
X     X 
X X   X
XXX  XX
X     X 
XXXXXXX