XXXXXXXXXX
X   XX   X
X   XX   X
XXX    XXX
XXX    XXX
X   XX   X
X   XX   X
XXXXXXXXXX