XXXXXXXXXXXX
XXXXXXXXXXXX
XX   XX   XX
XX   XX   XX
XXXX    XXXX
XXXX    XXXX
XX   XX   XX
XX   XX   XX
XXXXXXXXXXXX
XXXXXXXXXXXX