XXXXXXXXXXXX
XXXXXXXXXXXX
XX  XX    XX
XX  XX    XX
XX        XX
XXXXXXXXXXXX 
XXXXXXXXXXXX